C 164, 95, 190
F 56, 47, 96

NO ./textures/employee64.xpm
WE ./textures/innerglass64.xpm
EA ./textures/window64.xpm
SO ./textures/plainwall64.xpm

11111111111111111111
      11000000111111
11111111111111111111
10000S0011
10000000111
110000011
10000011
1000001111111111
1000000000000000111
111111111111111111111
